NO ./img/blackandwhite_theme/ronds.xpm
SO ./img/blackandwhite_theme/des.xpm	
WE ./img/blackandwhite_theme/losanges.xpm
EA ./img/blackandwhite_theme/briques.xpm

   F	   	0,200,0




C 0,128,255

11111111111111111
10000010000000001
10000010000100101
10000011S00100001
11111111011111111
10101000000000001  
10000000000000101
11111111111111111