NO ./img/blackandwhite_theme/ronds.xpm
SO ./img/blackandwhite_theme/des.xpm


C 200,30,38
EA              ./img/blackandwhite_theme/briques.xpm

                F 255,100,0
WE ./img/blackandwhite_theme/losanges.xpm


        1111111111111111111111111
        10000010A011000000000011 1
        101100000111000000000001 1
        1001000N000000000000000111
111111111011A00001110000000000001
100000000011000001110111111111111
1111011111111101110A000010001
1111D111111111011101010010001    1
11000000110101011100000010001   101
100000000000000011000000D0001    1       
1000000000000000110101001A001
110000A111010101111101111000111
11110111 1110101 101111010001
11111111 1111111 111111111111
1