WE ./img/color_theme/color_background_62.xpm

NO ./img/color_theme/color_background_88.xpm





		EA ./img/color_theme/color_background_86.xpm


F 48,48,48    

C          255,255,255

SO 			./img/color_theme/color_background_89.xpm


1111001
1111101
1111101
111110111
1100000111
1110000011
11000100111111
11000100111111
11000111111111
11000N00000011
111111111111
