WE ./img/color_theme/color_background_62.xpm

NO ./img/color_theme/color_background_88.xpm





		EA ./img/color_theme/color_background_86.xpm


F 48,48,48    

C          255,255,255

SO 			./img/color_theme/color_background_89.3.xpm

11111111
100A0001
11000001
1111D111
10000001
100N0001
11111111

