WE ./img/color_theme/bleu.xpm

NO ./img/color_theme/gris.xpm





		EA ./img/color_theme/rose.xpm


F 48,48,48    

C          255,255,255

SO 			./img/color_theme/beige.xpm

11111111
10000001
11000001
100000001
10001111
100N0001
11111111

