WE ./img/color_theme/color_background_62.xpm

NO ./img/color_theme/color_background_88.xpm





		EA ./img/color_theme/color_background_86.xpm


F 48,48,48    

C          255,255,255

SO 			./img/color_theme/color_background_89.3.xpm


1111111111111111111111111
10000000000000010010010001
100000000000D00D00D00D0001
1111111D111010010010010001
10000000001011111111111111
11D11111111111
100000000000001
1000N001111111
1111D111
1111D111
10000001
10000001
11111111