WE ./img/we.xpm

NO ./img/no.xpm





		EA ./img/ea.xpm


F 220,100,0     

C          225,30,0

SO 			./img/so.xpm

11111111
10000001
11000001
10000001
11000001
110000N1
11111111
