WE ./img/color_theme/color_background_62.xpm

NO ./img/color_theme/color_background_88.xpm





		EA ./img/color_theme/color_background_86.xpm


F 48,48,48    

C          255,255,255

SO 			./img/color_theme/color_background_89.xpm

11111111
10000011
1100A001
10001001
10D00001
10000001
1000N001
11111111
