WE ./img/color_theme/color_background_62.xpm

NO ./img/color_theme/color_background_88.xpm





		EA ./img/color_theme/color_background_86.xpm


F 48,48,48    

C          255,255,255

SO 			./img/color_theme/color_background_89.xpm

111111111111
1000000000001
1100000111101
1000000000101
1111D111110111
100000000000001
1000N001111111
11111111
11111111
