WE ./img/we.xpm

NO ./img/no.xpm





		EA ./img/ea.xpm


F 220,100,0     

C          225,30,0

SO 			./img/so.xpm

11111111
10000001
10000011
10000111
11000001
1100N011
11111111
