WE ./img/bluestone.xpm

NO ./img/colorstone.xpm





		EA ./img/greystone.xpm


F 220,100,0     

C          225,30,0

SO 			./img/eagle.xpm

11111111
10000001
10000001
10000111
10000001
1100N011
11111111
