WE ./img/Bricks_12-64x64.xpm

NO ./img/Bricks_20-64x64.xpm





		EA ./img/Bricks_19-64x64.xpm


F 48,48,48    

C          207,231,255

SO 			./img/Bricks_21-64x64.xpm

11111111
10000001
10000001
10000111
10000001
1100W011
11111111
