WE ./img/we.xpm

NO ./img/no.xpm





		EA ./img/ea.xpm


F 220,100,0     

C          225,30,0

SO 			./img/so.xpm

1111111
1000001
1000001
1000001
1000001
100N001
1111111
