WE ./img/blackandwhite_theme/black_background_26.2.xpm

NO ./img/blackandwhite_theme/black_background_47.2.xpm





		EA ./img/blackandwhite_theme/black_background_56.2.xpm


F 48,48,48    

C          255,255,255

SO 			./img/blackandwhite_theme/black_background_63.2.xpm

11111111
100000A1
111D1111
10000001
10000001
1111D111
10000001
10000001
100N0001
11111111

