NO ./img/blackandwhite_theme/ronds.xpm
SO ./img/blackandwhite_theme/des.xpm      
WE ./img/blackandwhite_theme/losanges.xpm
EA ./img/blackandwhite_theme/briques.xpm
   F	   	0,200,0




C 0,128,255
      1
111111N11111
1     1
1
1
1
1
1
1