WE ./img/color_theme/bleu.xpm

NO ./img/color_theme/gris.xpm





		EA ./img/color_theme/rose.xpm


F 48,48,48    

C          255,255,255

SO 			./img/color_theme/beige.xpm
WE ./img/color_theme/bleu.xpm
11111111
10000001
11000001
100000001
100011111
10000N001
111111111

