NO ./img/blackandwhite_theme/ronds.xpm
               SO ./img/blackandwhite_theme/des.xpm
EA ./img/blackandwhite_theme/briques.xpm







WE              ./img/blackandwhite_theme/losanges.xpm
   F	   	0,200,0






111111111111111111111111111111111111111
100000100A000000000000000000000000001
1000001000000101111111111000000011111
100A0000EA00A0001000000001A0000000101111
11111111D111111111110010D001000001001011
10101000000000101111111111111111111111
1A00000000000010000000000000D0000A0001
1100000001111110000000A00011100011111
10011D111000001100A0000000111000011
111000000000000000000110000010110001
111111100111001000000100000000111111
11000001111A0010000010000000001
10A0000D00001110000001000000111
1111111111110000A0000D0101011
            11111111111111111